1dgtl4p[c]	1-deoxy-L-glycero-tetrulose_4-phosphate
tre[e]	trehalose
no3[c]	nitrate
rib5p[c]	D-ribose-5-phosphate
ptpphygen[c]	protoporphyrinogen_IX
ctnycoa[c]	crotonoyl-CoA
5mtr1p[c]	5-methylthioribulose-1-phosphate
c1ala[e]	cob(I)alamin
2hisocap[c]	(R)-2-hydroxyisocaproate
cbpc3[c]	Cobalt-precorrin-3
6hm78dhpte[c]	6-hydroxymethyl-7,8-dihydropterin
adc5p[c]	adenosyl_cobalamin_5'-phosphate
sucr[c]	sucrose
s2a6kp[c]	N-succinyl-2-amino-6-ketopimelate
pantR[c]	(R)-pantoate
acap[c]	adenosyl-cobinamide_phosphate
cysL[c]	L-cysteine
pheL[e]	L-phenylalanine
pppi[c]	PPPi
nh3[c]	ammonia
hcy[c]	hydrogen_cyanide
3uprop[c]	3-ureidopropionate
78dhpte[c]	7,8-dihydropteroate
butp[c]	butanoyl_phosphate
4pptnD[c]	D-4'-phosphopantothenate
sh17bp[c]	sedoheptulose_1,7-bisphosphate
tcy[c]	thiocyanate
datp[c]	dATP
2a3ob[c]	2-amino-3-oxobutanoate
itp[c]	ITP
drib[c]	deoxyribose
naspdi[c]	N-acetylspermidine
argsuc[c]	L-arginino-succinate
dpcoa[c]	dephospho-CoA
ga6p[c]	D-glucosamine-6-phosphate
ptphyrin[c]	protoporphyrin_IX
2hisocapcoa[c]	(R)-2-hydroxyisocaproyl-CoA
fru1p[c]	fructose-1-phosphate
spmd[c]	spermidine
dethio[c]	dethiobiotin
fmn[c]	FMN
glyclt[c]	glycolate
fes[c]	corrinoid_Fe-S_protein
histd[c]	histidinol
oxac[c]	oxaloacetate
thm[e]	thiamin
ac[c]	acetate
CLP[c]	Cross-linked_peptidoglycan
fru16bp[c]	fructose-1,6-bisphosphate
actnS[c]	(S)-acetoin
5a3oh[c]	(S)-5-amino-3-oxohexanoate
serL[c]	L-serine
aga[c]	N-acetyl-beta-D-glucosamine
2o6pamg2d[c]	2-O-(6-phospho-alpha-D-mannosyl)-D-glycerate
Lip[c]	lipid
gccoa[c]	glutaconyl-CoA
na[c]	Na+
510methf[c]	5,10-methenyltetrahydrofolate
abdmagdpu[c]	N-acetyl-beta-D-mannosaminyl-1,4-N-acetyl-D-glucosaminyldiphosphoundecaprenol
ga1p[c]	D-glucosamine_1-phosphate
urea[c]	urea
2oiv[c]	2-oxoisovalerate
pyal[c]	pyridoxal
leuL[e]	L-leucine
dhettp[c]	alpha,beta-dihydroxyethyl-TPP
2a4op[c]	2-amino-4-oxopentanoate
nacaddn[c]	nicotinate_adenine_dinucleotide
m5trib1p[c]	S-methyl-5-thio-alpha-D-ribose_1-phosphate
2iac[c]	2-iminoacetate
hpsamdhllys[c]	H-protein-S-(aminomethyldihydrolipoyl)lysine
thm[c]	thiamin
nacput[c]	N-acetylputrescine
isocap[c]	Isocaproate
dad[c]	deoxyadenosine
2mbcoa[c]	2-methylbutanoyl-CoA
bio5a[c]	Biotinyl-5'-AMP
ribflv[c]	riboflavin
fum[c]	fumarate
fum[e]	fumarate
lacgth[c]	S-lactoyl-glutathione
4a5imzc[c]	4-amino-5-imidazole_carboxylate
dachi[e]	diacetylchitobiose
k[e]	K+
ornL[c]	L-ornithine
dcdp[c]	dCDP
5fithf[c]	5-formiminotetrahydrofolate
s26dap[c]	N-succinyl-L,L-2,6-diaminopimelate
acb[c]	adenosyl-cobyrate
hco3[c]	bicarbonate
adman[c]	alpha-D-mannose
35dah[c]	(3S,5S)-3,5-diaminohexanoate
gal6p[c]	D-galactose_6-phosphate
rz[c]	alpha-ribazole
pyin[e]	pyridoxine
uqnl8[c]	ubiquinol-8
ac[e]	acetate
cdpg[e]	CDP-glycerol
eto[e]	ethanol
din[c]	deoxyinosine
78dhnptetp[c]	7,8-dihydroneopterin_triphosphate
malt[e]	maltose
adn[c]	adenosine
2obut[c]	2-oxobutanoate
imzap[c]	imidazole_acetol-phosphate
dachi6p[c]	diacetylchitobiose-6-phosphate
gtol[e]	galactitol
da[c]	diacetyl
5a15pri4c[c]	5-amino-1-(5-phospho-D-ribosyl)imidazole-4-carboxylate
raf[c]	raffinose
tartsald[c]	tartronate_semialdehyde
ichor[c]	isochorismate
malacp[c]	malonyl[acp]
lpteichoic[c]	lipoteichoic_acid
4m2op[c]	4-methyl-2-oxopentanoate
5mthf[c]	5-methyl-tetrahydrofolate
glcAD[e]	alpha-D-glucose
12dh5mtp[c]	1,2-dihydroxy-5-(methylthio)pent-1-en-3-one
mthx5p[c]	1-methylthio-xylulose_5-phosphate
nadp[c]	NADP+
glyo[e]	glycerol
2s6h24ch1c[c]	2-succinyl-6-hydroxy-2,4-cyclohexadiene-1-carboxylate
thmp[c]	thiamin_phosphate
ppac[c]	phosphonoacetate
leuL[c]	L-leucine
mnl[e]	mannitol
citrL[c]	L-citrulline
tag6p[c]	tagatose-6-phosphate
2m3op[c]	2-methyl-3-oxopropanoate
idp[c]	IDP
nadh[c]	NADH
4m52poet[c]	4-methyl-5-(2-phosphonooxyethyl)thiazole
23dhbz[e]	2,3-dihydroxybenzoate
gly[c]	glycine
laldS[c]	(S)-lactaldehyde
glc6p[c]	beta-D-glucose-6-phosphate
fad[c]	FAD
5apn[c]	5-aminopentanoate
udpglu[c]	UDP-D-glucose
gly[e]	glycine
aglu[c]	N-acetyl-L-glutamate
thrL[c]	L-threonine
udpagaepyr[c]	UDP-N-acetylglucosamine-enolpyruvate
RNA[c]	ribonucleic_acid
skm[c]	shikimate
ppat[c]	phosphonate
vacoa[c]	vinylacetyl-CoA
tre6p[c]	trehalose_6-phosphate
imp[c]	IMP
glnL[e]	L-glutamine
aorn[c]	N-acetyl-L-ornithine
ppacal[c]	Phosphonoacetaldehyde
et4p[c]	D-erythrose-4-phosphate
gdp[c]	GDP
isobuta[e]	isobutyric_acid
fe2[e]	Fe2+
s3m2op[c]	(S)-3-methyl-2-oxopentanoate
4mpo[e]	4-methylphenol
fe2[c]	Fe2+
cmp[c]	CMP
at[c]	acetone
tmam[e]	trimethylamine
15pramp[c]	1-(5-phospho-D-ribosyl)-AMP
lysL[e]	L-lysine
c1ala[c]	cob(I)alamin
2sucbzcoa[c]	2-succinylbenzoyl-CoA
s5ddr5lhcys[c]	S-(5-deoxy-D-ribos-5-yl)-L-homocysteine
psuri5p[c]	pseudouridine_5'-phosphate
3ipm[c]	(2R,3S)-3-isopropylmalate
aacoa[c]	acetoacetyl-CoA
glcAD[c]	alpha-D-glucose
alaL[c]	L-alanine
actid[e]	Acetamide
tagd[e]	D-Tagaturonate
eimzgp[c]	D-erythro-imidazole-glycerol-phosphate
2a2hbut[c]	2-aceto-2-hydroxy-butanoate
mnl1p[c]	mannitol-1-phosphate
5a6raura[c]	5-amino-6-(D-ribitylamino)uracil
cobalt[e]	Co2+
14dh2no[c]	1,4-dihydroxy-2-naphthoate
tyrL[c]	L-tyrosine
pyam5p[c]	pyridoxamine_5'-phosphate
prfaca[c]	phosphoribosyl-formamido-carboxamide
23dhbz[c]	2,3-dihydroxybenzoate
pyam[c]	pyridoxamine
pepyr[c]	phosphoenolpyruvate
chol[e]	choline
hpyr[c]	hydroxypyruvate
alaL[e]	L-alanine
ca2[e]	Ca2+
isuc[c]	alpha-iminosuccinate
cysgly[c]	cys-gly
4hcoa[c]	4-hydroxybutanoyl-CoA
dctp[c]	dCTP
at[e]	acetone
udpamr[c]	UDP-N-acetylmuramate
g3p[c]	sn-glycerol-3-phosphate
2mbut[e]	2-Methylbutyric_acid
thymd[c]	thymidine
uri[e]	uridine
xan[e]	xanthine
acnam[c]	N-acetylneuraminate
5pra[c]	5-phospho-beta-D-ribosyl-amine
aacp[c]	apo[acp]
4hbut[c]	4-hydroxybutyrate
adp[c]	ADP
nac[c]	nicotinate
ctp[c]	CTP
uri[c]	uridine
hacp[c]	holo[acp]
udpamag[c]	UDP-N-acetylmuramoyl-L-alanyl-D-glutamate
4cyt5dp2me[c]	4-(cytidine_5'-diphospho)-2-C-methyl-D-erythritol
adpglu[c]	ADP-glucose
pppgpp[c]	pppGpp
5fthf[c]	5-formyl-tetrahydrofolate
4hoplac[c]	4-Hydroxyphenylacetate
5a15primz[c]	5-amino-1-(5-phospho-D-ribosyl)imidazole
2dh3dg[e]	2-dehydro-3-deoxy-D-gluconate
dad[e]	deoxyadenosine
5all[c]	5-aminolevulinate
ama6p[c]	N-acetyl-D-mannosamine-6-phosphate
escut[e]	esculetin
10fthf[c]	10-formyl-tetrahydrofolate
isobutp[c]	isobutanoylphosphate
acgdp[c]	adenosylcobinamide-GDP
glx[c]	glyoxylate
thmdp[c]	thiamin_diphosphate
ins[e]	inosine
ribflv[e]	riboflavin
23diap[c]	2,3-diaminopropanoate
5prfga[c]	5'-phosphoribosyl-N-formylglycineamide
cbprc6a[c]	cobalt-precorrin-6A
2mbut[c]	2-Methylbutyric_acid
escul[e]	esculin
fru[e]	D-fructose
ade[c]	adenine
nac[e]	nicotinate
betald[c]	betaine_aldehyde
glc[e]	beta-D-glucose
argL[e]	L-arginine
5pr4sc5ai[c]	5'-phosphoribosyl-4-(N-succinocarboxamide)-5-aminoimidazole
hisp[c]	L-histidinol-phosphate
actnR[c]	(R)-acetoin
4abat[c]	4-Aminobutanoate
gth[c]	reduced_glutathione
gth[e]	reduced_glutathione
6hmdhptedp[c]	6-hydroxymethyl-dihydropterin_diphosphate
cbp[c]	carbamoyl-phosphate
ileL[e]	L-isoleucine
mg2[e]	Mg2+
dcyt[e]	deoxycytidine
dcmp[c]	dCMP
4s45dhp23do[c]	(4S)-4,5-dihydroxypentan-2,3-dione
ileL[c]	L-isoleucine
glcn[c]	D-gluconate
pi[c]	phosphate
hexdp[c]	all-trans-hexaprenyl_diphosphate
k[c]	K+
1dxyl5p[c]	1-deoxy-D-xylulose_5-phosphate
sucsald[c]	succinate_semialdehyde
2aepat[c]	(2-aminoethyl)phosphonate
pendp[c]	all-trans-pentaprenyl_diphosphate
mevR[e]	(R)-mevalonate
ca2[c]	Ca2+
gmp[c]	GMP
2mccoa[c]	(E)-2-methylcrotonoyl-CoA
dump[c]	dUMP
csn[e]	cytosine
pyal5p[c]	pyridoxal_5'-phosphate
cbfIII[c]	Cobalt-factor_III
23dh3mv[c]	2,3-dihydroxy-3-methylvalerate
uqnn8[c]	ubiquinone-8
5pr1dp[c]	5-phospho-alpha-D-ribose_1-diphosphate
fuc[e]	L-fuculose
rl5p[c]	D-ribulose-5-phosphate
glc1pA[c]	alpha-D-glucose_1-phosphate
3pg[c]	3-phospho-D-glycerate
4s4h2345th2sdl[c]	(4S)-4-hydroxy-2,3,4,5-tetrahydro-(2S)-dipicolinate
67dm81rlum[c]	6,7-dimethyl-8-(1-D-ribityl)lumazine
lacR[c]	(R)-lactate
hcys[c]	L-homocysteine
nadph[c]	NADPH
5prga[c]	5-phospho-ribosyl-glycineamide
dgtp[c]	dGTP
proL[e]	L-proline
2mbutp[c]	2-methylbutanoyl-phosphate
xyld[e]	D-xylose
prfiaicarp[c]	phosphoribulosylformimino-AICAR-P
adprib[c]	ADP-ribose
r3hbat[c]	(R)-3-hydroxybutanoate
gtol1p[c]	galactitol-1-phosphate
5doadn[c]	5'-deoxyadenosine
alaala[c]	D-alanyl-D-alanine
pi[e]	phosphate
gluL[c]	L-glutamate
2pg[c]	2-phospho-D-glycerate
chol[c]	choline
dtdp[c]	dTDP
tyrL[e]	L-tyrosine
ibtal[c]	isobutanal
adcobamp[c]	adenosylcobinamide-phosphate
3dahs7p[c]	3-deoxy-D-arabino-heptulosonate-7-phosphate
4s45dhp23do[e]	(4S)-4,5-dihydroxypentan-2,3-dione
r3hbatcoa[c]	(R)-3-Hydroxybutanoyl-CoA|_crotonyl-CoA
acnam[e]	N-acetylneuraminate
alaD[c]	D-alanine
rbl5p[c]	L-ribulose-5-phosphate
trpL[e]	L-tryptophan
ncammnuc[c]	nicotinamide_mononucleotide
cbshclin[c]	Cobalt-sirohydrochlorin
sor[e]	D-sorbitol
glyald3p[c]	D-glyceraldehyde-3-phosphate
hoam[c]	Hydroxylamine
raf[e]	raffinose
isobutcoa[c]	isobutanyryl-CoA
2drib1p[c]	2-deoxy-alpha-D-ribose_1-phosphate
1h2m2b4dp[c]	1-hydroxy-2-methyl-2-(E)-butenyl_4-diphosphate
uri5p[c]	uridine-5'-phosphate
cbdhpcr6[c]	Cobalt-dihydro-precorrin_6
nacmnc[c]	nicotinate_mononucleotide
aga6p[c]	N-acetyl-D-glucosamine-6-phosphate
so3[c]	sulfite
so3[e]	sulfite
isobuta[c]	isobutyric_acid
15pr55pramai4c[c]	1-(5-phosphoribosyl)-5-[(5-phosphoribosylamino)methylideneamino]imidazole-4-carboxamide
dttp[c]	dTTP
arab[e]	L-arabinose
ibtol[c]	isobutanol
celb[e]	cellobiose
4aimz[c]	4-aminoimidazole
thf[c]	tetrahydrofolate
thioredoxoxi[c]	oxidized_thioredoxin
fmnh2[c]	FMNH2
glc1p[c]	beta-D-glucose_1-phosphate
36dah[c]	(3S)-3,6-diaminohexanoate
hista[c]	histidinal
malt[c]	maltose
ncam[e]	nicotinamide
co[c]	carbon_monoxide
udpamagdap[c]	UDP-N-acetylmuramoyl-L-alanyl-D-glutamyl-meso-2,6-diaminopimelate
xyld[c]	D-xylose
fald[c]	formaldehyde
dap[c]	L,L-diaminopimelate
chor[e]	chorismate
dtmp[c]	dTMP
ptrc[e]	putrescine
metL[e]	L-methionine
no2[c]	nitrite
aro[c]	L-arogenate
CW[c]	Cell_Wall
fru[c]	D-fructose
4ppcys[c]	R-4'-phosphopantothenoyl-L-cysteine
4abg[e]	4-aminobenzoate-glutamate
aspsald[c]	L-aspartate-semialdehyde
lacS[c]	(S)-lactate
lacS[e]	(S)-lactate
udpama[c]	UDP-N-acetyl-D-mannosamine
man6p[c]	D-mannose_6-phosphate
cdpg[c]	CDP-glycerol
orot[c]	orotate
78dhnpte3p[c]	7,8-dihydroneopterin_3'-phosphate
thr3p[c]	L-threonine_O-3-phosphate
sor[c]	D-sorbitol
hgcvpdhllys[c]	H-Gcv-protein-(dihydrolipoyl)lysine
sprm[c]	spermine
aspL[e]	L-aspartate
fesm[c]	methylated_corrinoid_Fe-S_protein
fadh2[c]	FADH2
2dh3dg6p[c]	2-dehydro-3-deoxy-D-gluconate-6-phosphate
ahcys[c]	S-adenosyl-L-homocysteine
ibtol[e]	isobutanol
cbpc4[c]	Cobalt-precorrin-4
aga1p[c]	N-acetyl-alpha-D-glucosamine_1-phosphate
cysL[e]	L-cysteine
4a2m5dpmp[c]	4-amino-2-methyl-5-diphosphomethylpyrimidine
xyl[c]	D-xylulose
4u5imzc[c]	4-ureido-5-imidazole_carboxylate
cobalt[c]	Co2+
gal[e]	beta-D-galactose
celb6p[c]	cellobiose_6-phosphate
thrL[e]	L-threonine
rblL[c]	L-ribulose
asp4p[c]	L-aspartyl-4-phosphate
dgdp[c]	dGDP
aspL[c]	L-aspartate
78dhnpte[c]	7,8-dihydro-D-neopterin
udpaga[c]	UDP-alpha-N-acetyl-D-glucosamine
ptth[c]	pantetheine
ppat[e]	phosphonate
argL[c]	L-arginine
ppcoa[c]	propanoyl-CoA
udpamagdapaa[c]	UDP-N-acetylmuramoyl-L-alanyl-D-glutamyl-meso-2,6-diaminopimelyl-D-alanyl-D-alanine
m5trib[c]	S-methyl-5-thio-D-ribose
4mpo[c]	4-methylphenol
udpagapp[c]	undecaprenyl-N-acetyl-alpha-D-glucosaminyl-pyrophosphate
valL[c]	L-valine
hcit[c]	homocitrate
succ[c]	succinate
succ[e]	succinate
dgsn[c]	deoxyguanosine
unsc[c]	unsulfurated_[sulfur_carrier]
2ipm[c]	(2S)-2-isopropylmalate
isocap[e]	Isocaproate
4m5het[c]	4-methyl-5-(beta-hydroxyethyl)thiazole
56dhura[c]	5,6-dihydrouracil
hepdp[c]	all-trans-heptaprenyl_diphosphate
ap[c]	acetylphosphate
pyr[c]	pyruvate
duri[c]	deoxyuridine
pntoR[c]	(R)-pantothenate
casp[c]	N-carbamoyl-L-aspartate
2but[c]	2-butanoate
pc1[c]	precorrin-1
suchser[c]	O-succinyl-L-homoserine
3a2mp[c]	(R)-3-amino-2-methylpropanoate
6pg15l[c]	6-phospho-D-glucono-1,5-lactone
for[e]	formate
asnL[c]	L-asparagine
dethio[e]	dethiobiotin
glc[c]	beta-D-glucose
cysthL[c]	L-cystathionine
adcbam[c]	adenosylcobinamide
2sucbz[c]	2-succinylbenzoate
atp[c]	ATP
metD[c]	D-methionine
glcn[e]	D-gluconate
teichoic[c]	teichoic_acid
feroxred[c]	reduced_ferredoxin
elecacceptred[c]	reduced_electron_acceptor
2maacoa[c]	2-methylacetoacetyl-CoA
no2[e]	nitrite
altd[c]	D-altronate
23diap[e]	2,3-diaminopropanoate
adman[e]	alpha-D-mannose
his[e]	L-histidine
co2[c]	CO2
2dmmqn[c]	2-demethylmenaquinone
trpL[c]	L-tryptophan
cppogen3[c]	coproporphyrinogen_III
isop[c]	isopentanoylphosphate
3uib[c]	3-ureido-isobutyrate
4abald[c]	4-aminobutyraldehyde
thioredoxred[c]	reduced_thioredoxin
dmadp[c]	dimethylallyl_diphosphate
tmam[c]	trimethylamine
hser[c]	L-homoserine
ura[c]	uracil
bio[e]	biotin
xmp[c]	XMP
glyc[c]	D-glycerate
5apn[e]	5-aminopentanoate
fardp[c]	(2E,6E)-farnesyl_diphosphate
coB12[c]	coenzyme_B12
ncamrib[c]	nicotinamide-beta-riboside
4ppt[c]	4'-phosphopantetheine
cytd[c]	cytidine
malt6p[c]	maltose_6-phosphate
ins[c]	inosine
thymd[e]	thymidine
gsn[c]	guanosine
serL[e]	L-serine
for[c]	formate
amet[c]	S-adenosyl-L-methionine
uppg3[c]	uroporphyrinogen-III
isocaprecoa[c]	2-Isocaprenoyl-CoA
3ppyr[c]	3-Phosphonopyruvate
g3p[e]	sn-glycerol-3-phosphate
agmp[c]	N-acetylglutamyl-phosphate
cobat[c]	Cobyrinate
aglu5sald[c]	N-acetyl-L-glutamate_5-semialdehyde
glc6pA[c]	alpha-D-glucose_6-phosphate
nad[c]	NAD+
h2[e]	H2
drin1p[c]	deoxyribose-1-phosphate
4abg[c]	4-aminobenzoate-glutamate
dutp[c]	dUTP
urea1c[c]	urea-1-carboxylate
hxan[c]	hypoxanthine
proL[c]	L-proline
phser[c]	O-phospho-L-homoserine
ptcys[c]	N-((R)-pantothenoyl)-L-cysteine
aac[c]	acetoacetate
etoa[c]	ethanolamine
aald[c]	acetaldehyde
hxan[e]	hypoxanthine
2aepat[e]	(2-aminoethyl)phosphonate
ppgpp[c]	ppGpp
5a65praura[c]	5-amino-6-(5-phospho-D-ribitylamino)uracil
hmb[c]	hydroxymethylbilane
4imzo[c]	4-imidazolone
5epyrsk3p[c]	5-enolpyruvyl-shikimate-3-phosphate
2me4p[c]	2-C-methyl-D-erythritol-4-phosphate
2o6pamg2d[e]	2-O-(6-phospho-alpha-D-mannosyl)-D-glycerate
ival[e]	Isovalerate
m5tade[c]	S-methyl-5'-thioadenosine
DNA[c]	deoxyribonucleic_acid
pheL[c]	L-phenylalanine
amp[c]	AMP
pphn[c]	prephenate
aga[e]	N-acetyl-beta-D-glucosamine
4abz[c]	4-aminobenzoate
udpcpp[c]	ditrans,octacis-undecaprenyl_phosphate
rib1p[c]	alpha-D-ribose-1-phosphate
mql[c]	menaquinol
xan[c]	xanthine
proD[c]	D-proline
btal[c]	butanal
pntoR[e]	(R)-pantothenate
gal[c]	beta-D-galactose
24dap[c]	(2R,4S)-2,4-diaminopentanoate
cbpcr5b[c]	cobalt-precorrin-5B
13bpg[c]	1,3-bisphospho-D-glycerate
na[e]	Na+
gdpm[c]	GDP-alpha-D-mannose
elecacceptoxi[c]	oxidized_electron_acceptor
malS[e]	(S)-malate
hgcvpllys[c]	H-Gcv-protein-(lipoyl)lysine
buta[c]	n-butanol
4a4dchor[c]	4-amino-4-deoxychorismate
tgt[e]	tagatose
acon[c]	cis-aconitate
h2o[c]	H2O
glyald[c]	D-glyceraldehyde
icit[c]	isocitrate
ch4s[c]	methanethiol
fru6p[c]	D-fructose-6-phosphate
his[c]	L-histidine
lysL[c]	L-lysine
dho[c]	(S)-dihydroorotate
gal1pA[c]	alpha-D-galactose_1-phosphate
78dhfmg[c]	7,8-dihydrofolate_monoglutamate
3h3mgcoa[c]	(S)-3-hydroxy-3-methylglutaryl-CoA
ptrc[c]	putrescine
ahser[c]	O-acetyl-L-homoserine
malS[c]	(S)-malate
2m3hbcoa[c]	2-methyl-3-hydroxybutyryl-CoA
tsul[c]	thiosulfate
h[c]	H+
succoa[c]	succinyl-CoA
dapime[c]	meso-diaminopimelate
ametam[c]	S-adenosyl-L-methioninamine
agm[c]	agmatine
zn2[e]	Zn2+
3mpyr[c]	3-mercaptopyruvate
mevR[c]	(R)-mevalonate
ura[e]	uracil
udpamala[c]	UDP-N-acetylmuramyl-L-Ala
mg2[c]	Mg2+
sor6p[c]	D-sorbitol-6-phosphate
alaB[c]	beta-alanine
actid[c]	Acetamide
ctncoa[c]	crotonyl-CoA
2345thd[c]	(S)-2,3,4,5-tetrahydrodipicolate
xtsn[c]	xanthosine
dadp[c]	dADP
bio[c]	biotin
escul[c]	esculin
serD[c]	D-serine
rz5p[c]	alpha-ribazole-5'-phosphate
adn[e]	adenosine
1a2po2p[c]	(R)-1-amino-2-propanol_O-2-phosphate
dgo15lac[c]	D-glucono-1,5-lactone
glyo[c]	glycerol
fruf[c]	beta-D-fructofuranose
hicit[c]	homoisocitrate
shl7p[c]	D-sedoheptulose-7-phosphate
proheme[c]	protoheme_IX
dcyt[c]	deoxycytidine
2ippm[c]	2-isopropylmaleate
3phpyr[c]	3-phospho-hydroxypyruvate
nh3[e]	ammonia
biomass[c]	Biomass
5prfgad[c]	5-phosphoribosyl-N-formylglycineamidine
h[e]	H+
ribD[e]	D-ribose
c1yda[c]	cob(I)yrinate_a,c-diamide
2h3k5mt1pp[c]	2-hydroxy-3-keto-5-methylthio-1-phosphopentene
asucc[c]	adenylo-succinate
escut[c]	esculetin
56dmbimz[c]	5,6-dimethylbenzimidazole
2ip3os[c]	(2S)-2-isopropyl-3-oxosuccinate
coa[c]	coenzyme_A
feroxoxi[c]	oxidized_ferredoxin
25da65prap[c]	2,5-diamino-6-(5-phospho-D-ribosylamino)pyrimidin-4(3H)-one
acbda[c]	adenosyl-cobyrinate_a,c-diamide
asnL[e]	L-asparagine
3dhq[c]	3-dehydroquinate
mthgxl[c]	methylglyoxal
3pser[c]	3-phospho-L-serine
man1p[c]	alpha-D-mannose_1-phosphate
sucr[e]	sucrose
zn2[c]	Zn2+
ssc[c]	sulfurated_[sulfur_carrier]
h2[c]	H2
dgmp[c]	dGMP
2dh3dg[c]	2-dehydro-3-deoxy-D-gluconate
acoa[c]	acetyl-CoA
co2[e]	CO2
2alac[c]	2-acetolactate
cit[c]	citrate
celb[c]	cellobiose
glyb[c]	glycine_betaine
mqn[c]	menaquinone
ornD[c]	D-ornithine
udpagaepyr[e]	UDP-N-acetylglucosamine-enolpyruvate
isocapcoa[c]	Isocaproyl-CoA
ncam[c]	nicotinamide
tagd[c]	D-Tagaturonate
sucr6p[c]	sucrose-6-phosphate
6pg[c]	6-phospho-D-gluconate
r5p[c]	D-ribitol_5-phosphate
udp[c]	UDP
csn[c]	cytosine
glyb[e]	glycine_betaine
3abcoa[c]	L-3-aminobutyryl-CoA
gcald[c]	glycolaldehyde
fgly[c]	N-formimino-glycine
spmd[e]	spermidine
quln[c]	quinolinate
gpgl[c]	glycerophosphoglycoglycerolipid
ppi[c]	diphosphate
4hplald[c]	4-Hydroxyphenylacetaldehyde
damp[c]	dAMP
hoam[e]	Hydroxylamine
2me24cdp[c]	2-C-methyl-D-erythritol-2,4-cyclodiphosphate
naspin[c]	N-acetylspermine
gtp[c]	GTP
grgrdp[c]	geranylgeranyl_diphosphate
valL[e]	L-valine
ama[c]	N-acetyl-D-mannosamine
ivalcoa[c]	isovaleryl-CoA
pratp[c]	phosphoribosyl-ATP
SPs[c]	Solute_Pools
xyl5p[c]	D-xylulose-5-phosphate
metD[e]	D-methionine
c2yda[c]	cob(II)yrinate_a,c-diamide
ipdp[c]	isopentenyl_diphosphate
udpgal[c]	UDP-D-galactose
pap[c]	adenosine_3',5'-bisphosphate
aimzcrnt[c]	aminoimidazole_carboxamide_ribonucleotide
orot5p[c]	orotidine-5'-phosphate
2dhp[c]	2-dehydropantoate
h2o[e]	H2O
cbpcr7[c]	cobalt-precorrin-7
shclin[c]	Sirohydrochlorin
23dh23dhvz[c]	2,3-dihydro-2,3-dihydroxybenzoate
gluD[c]	D-glutamate
gluL[e]	L-glutamate
thym[c]	thymine
2drib5p[c]	2-deoxy-D-ribose-5-phosphate
pc2[c]	precorrin-2
510mlethf[c]	5,10-methylenetetrahydrofolate
skm3p[c]	shikimate-3-phosphate
2oa[c]	2-oxoadipate
galA[c]	alpha-D-galactose
2p4c5dp2me[c]	2-phospho-4-(cytidine_5'-diphospho)-2-C-methyl-D-erythritol
utp[c]	UTP
dudp[c]	dUDP
56dhthy[c]	5,6-dihydrothymine
metL[c]	L-methionine
h2s[c]	hydrogen_sulfide
hco3[e]	bicarbonate
ribD[c]	D-ribose
udcpdp[c]	di-trans,octa-cis-undecaprenyl_diphosphate
p1p3b5adtp[c]	P1,P3-Bis(5'-adenosyl)_triphosphate
4abz[e]	4-aminobenzoate
malsald[c]	malonate_semialdehyde
3dhsk[c]	3-dehydroshikimate
glnL[c]	L-glutamine
gua[c]	guanine
cbpcr8x[c]	cobalt-precorrin-8x
tag16bp[c]	tagatose-1,6-bisphosphate
cbprc5a[c]	cobalt-precorrin-5A
34hppyr[c]	3-(4-hydroxyphenyl)pyruvate
malcoa[c]	malonyl-CoA
pbng[c]	porphobilinogen
ival[c]	Isovalerate
etoa[e]	ethanolamine
dhap[c]	dihydroxyacetone_phosphate
5a65prsaura[c]	5-amino-6-(5-phospho-D-ribosylamino)uracil
no3[e]	nitrate
5mt23dopp[c]	5-(methylthio)-2,3-dioxopentyl_phosphate
gcoa[c]	glutaryl-CoA
phpyr[c]	phenylpyruvate
arab[c]	L-arabinose
pyin[c]	pyridoxine
grdp[c]	geranyl_diphosphate
octdp[c]	all-trans-octaprenyl_diphosphate
chor[c]	chorismate
eto[c]	ethanol
2oglut[c]	2-oxoglutarate
2oglut[e]	2-oxoglutarate
Prot[c]	protein
cdp[c]	CDP
fuc1p[c]	L-fuculose_1-phosphate
4a2m5pmp[c]	4-amino-2-methyl-5-phosphomethylpyrimidine
prpnte[c]	Propanoate
cmylphosph[c]	Carbamoyl_phosphate
ncmylasp[c]	N-carbamoyl-L-aspartate
glusemald[c]	L-Glutamate_5-semialdehyde
2am2prpnte[c]	2-aminoprop-2-enoate
palmacd[c]	palmitic_acid_(Hexadecanoic_aicd)___C16:0
butacp[c]	butyryl-[acp]
hexacp[c]	hexanoyl-acp
octacp[c]	octanoyl-[acp]
decacp[c]	decanoyl-acp
dodecacp[c]	dodecanoyl-[acp]
myrstacp[c]	myristoyl-[acp]
palmacp[c]	palmitoyl-[acp]
sracp[c]	Stearoyl-Acp
btcoa[c]	butanoyl-CoA
hexcoa[c]	hexanoyl-CoA
octcoa[c]	octanoyl-CoA
deccoa[c]	decanoyl-CoA
dodeccoa[c]	dodecanoyl-CoA
myrstcoa[c]	myristoyl-CoA
palmcoa[c]	palmitoyl-CoA
srcoa[c]	Stearoyl-CoA
3hydroxybutacp[c]	(3R)-3-Hydroxybutanoyl-[acyl-carrier_protein];
3hydroxyhexacp[c]	(3R)-3-hydroxyhexanoyl-[acp]
3hydroxyoctacp[c]	(3R)-3-hydroxyoctanoyl-[acp]
3hydroxydecacp[c]	(3R)-3-hydroxydecanoyl-[acp]
3hydroxydodecacp[c]	(3R)-3-hydroxydodecanoyl-[acp]
3hydroxymyristacp[c]	(3R)-3-hydroxymyristoyl-[acp]
3hydroxypalmacp[c]	(3R)-3hydroxypalmitoyl-[acp]
3hbcoa[c]	(S)-3-hydroxybutanoyl-CoA
3hydroxyhexcoa[c]	(S)-Hydroxyhexanoyl-CoA;
3hydroxyoctcoa[c]	(S)-3-Hydroxyoctanoyl-CoA;
3hydroxydeccoa[c]	(S)-Hydroxydecanoyl-CoA;
3hydroxydodeccoa[c]	(S)-3-Hydroxydodecanoyl-CoA
3hydroxymyristcoa[c]	(S)-3-Hydroxytetradecanoyl-CoA
3hydroxypalmcoa[c]	(S)-3-Hydroxyhexadecanoyl-CoA
3oxohexacp[c]	3-oxo-hexanoyl-[acp]
3oxooctacp[c]	3-oxo-octanoyl-[acp]
3oxodecacp[c]	3-oxo-decanoyl-[acp]
3oxododecacp[c]	3-oxo-dodecanoyl-[acp]
3oxomyristacp[c]	3-oxo-myristoyl-[acp]
3oxopalmacp[c]	3-oxo-palmitoyl-[acp]
3oxohexcoa[c]	3-Oxohexanoyl-CoA|3-Ketohexanoyl-CoA
3oxooctcoa[c]	3-oxo-octanoyl-coa
3oxodeccoa[c]	3-oxo-decanoyl-coa
3oxododeccoa[c]	3-oxo-dodecanoyl-coa
3oxomyristcoa[c]	3-oxo-myristoyl-coa
3oxopalmcoa[c]	3-oxo-palmitoyl-coa
but2enacp[c]	But-2-enoyl-[acyl-carrier_protein]
thex2enacp[c]	trans_hex-2-enoyl-[acp]
toct2enacp[c]	trans_oct-2-enoyl-[acp]
2dec2enacp[c]	(2E)-dec-2-enoyl-[acp]
2dodec2enacp[c]	(2E)-dodec-2-enoyl-[acp]
ttetdec2enoylacp[c]	trans_tetradec-2-enoyl-[acp]
thexdecenoylacp[c]	trans_hexadecenoyl-[acp]
but2encoa[c]	But-2-enoyl-coa
thex2encoa[c]	trans_hex-2-enoyl-coa
toct2encoa[c]	trans_oct-2-enoyl-coa
2dec2encoa[c]	(2E)-dec-2-enoyl-coa
2dodec2encoa[c]	(2E)-dodec-2-enoyl-coa
ttetdec2enoylcoa[c]	trans_tetradec-2-enoyl-coa
thexdecenoylcoa[c]	trans_hexadecenoyl-coa
acacp[c]	acetyl_acyl-carrier_protein
acacacp[c]	acetoacetyl-[acp]
1hexdecg3p[c]	1-hexadecanoyl-sn-glycerol_3-phosphate
1tetdecg3p[c]	1-tetradecanoyl-sn-glycerol_3-phosphate
1octdecg3p[c]	1-octadecanoyl-sn-glycerol_3-phosphate
12dhexdec3gp[c]	1,2-dihexadecanoyl-sn-glycerol_3-phosphate
12dtetradecg3p[c]	1,2-ditetradecanoyl-sn-glycerol_3-phosphate
12dioctdecg3p[c]	1,2-dioctadecanoyl-sn-glycerol_3-phosphate
mglucsyldpalmgl[c]	Monoglucosyl-1,2_dipalmitoylglycerol
mglucsyldmygl[c]	Monoglucosyl-1,2_dimyristoylglycerol
mglucsyldstgl[c]	Monoglucosyl-1,2_distearoylglycerol
dgludpalmgl[c]	Diglucosyl-1,2_dipalmitoylglycerol
dgludmygl[c]	Diglucosyl-1,2_dimyristoylglycerol
digludstgl[c]	Diglucosyl-1,2_distearoylglycerol
12dgdihexdec[c]	1,2-Diacyl-sn-glycerol_dihexadecanoyl
12dgditetdec[c]	1,2-Diacyl-sn-glycerol_ditetradecanoyl
12dgdioctdec[c]	1,2-Diacyl-sn-glycerol_dioctadecanoyl
cdpdhexdecglc[c]	CDP-1,2-dihexadecanoylglycerol
cdpdtetdecglc[c]	CDP-1,2-ditetradecanoylglycerol
cdpoctdecglc[c]	CDP-1,2-dioctadecanoylglycerol
pgpdihexdec[c]	Phosphatidylglycerophosphate_dihexadecanoyl
pgpditetdec[c]	Phosphatidylglycerophosphate_ditetradecanoyl
pgpdioctdec[c]	Phosphatidylglycerophosphate_dioctadecanoyl
phosglcdihexdec[c]	Phosphatidylglycerol_dihexadecanoyl
phosglcditetdec[c]	Phosphatidylglycerol_ditetradecanoyl
phosglcdioctdec[c]	Phosphatidylglycerol_dioctadecanoyl
palmphgl[c]	Palmitoyllysylphophatidylglycerol
myrphgl[c]	Myristoyllysylphophatidylglycerol
strphglc[c]	Stearoyllysylphophatidylglycerol
palmcdlpn[c]	Palmitoylcardiolipin_
mycdlpn[c]	Myristoylcardiolipin_
strcdlpn[c]	Stearoylcardiolipin
pmf[c]	Proton_motive_force
dgslnt[c]	Selenodiglutathione
gslnt[c]	Glutathiolselenolate
sectrna[c]	L-Selenocysteinyl-tRNA(Sec)
sertrnasec[c]	L-Seryl-tRNA(Sec)
sel[c]	Selenate
sel[e]	Selenate
seln[c]	Selenide
selnp[c]	Selenophosphate
slnt[c]	selenite
slnt[e]	selenite
selenlhcys[c]	seleno-L-homocysteine
selencysthne[c]	L-selenocystathionine
trnasecys[c]	tRNA(SeCys)
gthox[c]	Oxidized_glutathione
gthox[e]	Oxidized_glutathione
selprotein[c]	Selenoprotein
pyr5carb[c]	pyrroline-5-carboxylate
